




11111
1PEC1
11111









