




111111111111111
1PECCCCCCCCCCC1
111111111111111









