




1111111111111111111111111111111111
100P000000000000X00000000000000001
10000010000000EC000000000101000001
1111101000000000000000000000010001
1111111111111111111011111111111111
1111111111111111111111111111111111
1111111111111111111111111111111111









