1111111111111111111111111111111111
1000001000000000000000000010000001
10P00010000000000000000001C1000001
1111111000000000000000000000010001
10000C0000000000000000000000010001
1000000000000000000000000000010001
1000000000000000000000000000010001
1000000000000000000000000000000001
100000000C000000000000000000000001
1000000000111111111111110000000001
1000000000000000000000000000000001
1000000000000000000000000000000001
1000000000000000000C00000000000001
10000000000000000000000000000000E1
1111111111111111111111111111111111









