





1111111111111111111111111111111111
1000001000000000000000000010000001
10000010000000000000000001C1000001
11111C1000000000000000000000010001
1000000000000000000000000000010001
1000000000000000000000000000010001
1000000000000CCCC11111000000010001
1000000000000000000000000000000001
100000000C000000000000000000E00001
1000000000111111111111110000000001
1000000000000000000000000000X00001
1000000000000000000000000000000001
1000000000000000000000000000C00001
1000000000000000000000000000000001
1000000000000000000000000000000001
1000000000000000000000000000P00001
1000000000000000000000000000000001
1000000000000000000C00001101111111
1000000000000000000000001000000001
1111111111111111111111111111111111









