





1111111111111111111111111111111111
1000001000000000000000000010000001
10P00010000000000000000001C1000001
11111C1000000000000000000000010001
1000000000000000000000000000010001
1000000000000000000000000000010001
1000000000000CCCC11111000000010001
1000000000000000000000000000000001
100000000C000000000000000000000001
1000000000111111111111110000000001
1000000000000000000000000000000001
1000000000000000000000000000000001
1000000000000000000000000000000001
1000000000000000000000000000000001
1000000000000000000000000000000001
1000000000000000000000000000000001
1000000000000000000000000000000001
1000000000000000000C00001101111111
10000000000000000000000010000000E1
1111111111111111111111111111111111









