11111111111111111111111111
1P011111111111111111111E11
11011111111111111111111011
11000100010000000010100011
11011101110101011110101011
11000000000001010000101011
11110101110011011010001011
10000100010101000010100011
10111111111111111111111011
1C111111111111111111111C11
11111111111111111111111111